3

20 7
####################
#444444444444444444D
#444444444444444444#
#444444444444444444#
#4444S4444444444444#
#444444444444444444#
####################
2 1


20 7
####################
D555555#55555555555#
#555555#55555555555D
#555555#55555555555#
#5555S5#55555555555#
#555555955555555555#
####################
1 1
3 1

20 7
####################
#333333#33333333333#
D333333#3333333B333#
#333333#33333333333#
#3333S3#33333333333#
#333333333333333333#
####################
2 2
